20,12
....................
....................
....................
....................
....................
....................
....................
....................
.........==.........
.......======.......
....============....
====================