20,12
....................
....................
.===................
....................
......===...........
....................
...........===......
....................
................===.
....................
....................
====================