20,12
....................
....................
....................
.....====...........
....................
....................
....................
...........===......
..==................
....................
....................
====================