20,12
....................
....................
....................
....................
===..............===
....................
....===......===....
....................
........====........
....................
....................
====================